########################################
#!                                     #
# #@#@#@#@#@#@#@#@#@#@#@#@@#@#@#@#@#@# #
# @       #                @      @ /@ #
# #   @   @             ## #      @  # #
# @       #             #  @#@#@#@#  @ #
# #####  #@  @          #         @#@# #
# @   @    # @    @#@@  #            @ #
# #                  #  #    @#@###@## #
# @       @        ! @  #    #       # #
# #@  @    #         @  #    @       # #
#   @      #  @  @@@#@  #    @       # #
# #        #  @         #    @       # #
# @@##@@   #            #    #       @ #
# #   @@   #  @    @    #    @       # #
# @   #@  ##  @    @    ###  #       @@#
# #D  @@      @    @         #         #
# #@#@#@#@#@@@#@#@#@#@#@#@@#@#@#@#@@   #
#                               !  @  !#
########################################
