########################################
#/                                    !#
# #@#@#@#@#@#@# #@# #@#@#@@#@#@#@#@#@# #
# @       #                @         @ #
# #   @   @             ## #         # #
# @       #             #  @#@#@#@#@ @ #
# #####  #@   @@@@@@@   #          # # #
# @   @    #  @@#@#@@   #            @ #
# #           @#   #@   #            # #
# @       @   @@ D @@   #              #
# #@  @    #  @#   #@   #  ######### # #
#   @      #  @@#@#@@   #              #
# #        #  @@@@@@@   #            # #
#  @###    #            # !          @ #
# #        #  @    @    #            # #
#         ##  @    @    ###         ## #
# #           @    @                 # #
# #@#@#@#@#@@@#@#@#@#@#@#@@#@#@#@#@#   #
#!                                    !#
########################################
