########################################
#        !                            !#
# #@#@#@#@#@#@# #@# #@#@#@@#@#@#@#@#@# #
# @D@     #                @         @ #
# #@@ @   @             ##@#         # #
# @       #             #  @#@#@#@#@ @ #
# #####  #@             @          # # #
# @   @    #      @#@@  #            @ #
# #               !  #  #    @#@###@@  #
# @       @          @  @    #       # #
# #@  @    #         @  #    @       # #
#   @      #  @  @@@#@  #    @       # #
# #        #  @         @    @       # #
#  @###    #            #    #       @ #
# #        #  @    @    #    @       # #
#!        ##  @    @    @@#@@#     @@@@#
# #           @    @         #     @   #
# #@#@#@#@#@@@#@#@#@#@#@#@@#@#@#@#@@   #
#                                  @  /#
########################################
